NO assets/nyc.png
SO assets/nyc.png
WE assets/nyc.png
EA assets/nyc.png

F 105,105,105
C 40,75,160

1111111111111111111111111
1000000000110000000000101
100H0000000000000000H0101
1000W00001110000000000101
1000000000110111111111101
1111011111011100000010001
1111011111011101010010001
1100000101011100000010001
1000000000000000000000001
1000000000001101010010001
1100000111010101111000111
1111011111010101111010001
1111111111111111111111111
