NO assets/nyc.png
SO assets/nyc.png
WE assets/nyc.png
EA assets/nyc.png

F 105,105,105
C 40,75,160

111111111111111111111111111111
100000000011000000000000000101
1000H00000000000000000000H0101
1000W0000111000000000000000101
100000000011011111000001111101
111101110101110000000000010001
111101110101110101000000010001
110000010101110000000000010001
1000000101000000000000H0000001
100000010100110101000000010001
110000010101010110000011000111
100000010100000000000000000001
100000010100110101000000010001
110000010111010110000011000111
1000H0010000000000000000000001
100000011110110101000000010001
110000011101010111100000000111
100000000000000000000H00000001
100000000000110101000000010001
110000011101010111100000000111
111101111101010111101000000001
111111111111111111111111111111
