NO assets/base.png
SO assets/wall.png
WE assets/player.png
EA assets/exit.png

F 168,235,52
C 225,255,10

1111111111111111111111111
1000000000110000000000101
10010000000100N0000000101
1011000001110000000000101
1000000000110111111111101
1111011111011100000010001
1111011111011101010010001
1100000101011100000010001
1000000000000000000000001
1000000000001101010010001
1100000111010101111000111
1111011111010101111010001
1111111111111111111111111
