NO assets/tile_no.png
SO assets/tile_so.png
WE assets/tile_we.png
EA assets/tile_ea.png

F 168,235,52
C 225,255,10

1111111111111111111111111
1000000000110000000000101
1001000000000000000000101
1011000001110000000000101
1000000000110111111111101
1111011111011100000010001
1111011111011101010010001
1100000101011100000010001
1000000000000000000000001
1000000000001101010010001
1100000111010101111000111
111101111101010111101N001
1111111111111111111111111
