NO assets/nyc.png
SO assets/nyc.png
WE assets/nyc.png
EA assets/nyc.png

F 105,105,105
C 40,75,160

111111111111111111111111111111
100000000011000000000000000101
100H000000000000000000000H0101
1000W0000111000000000000000101
100000000011011111000001111101
111101111101110000000000010001
111101111101110101000000010001
110000010101110000000000010001
100000000000000000000000000001
100000000000110101000000010001
110000011101010110000011000111
100000000000000000000000000001
100000000000110101000000010001
110000011101010110000011000111
100000000000000000000000000001
100000000000110101000000010001
110000011101010111100000000111
100000000000000000000000000001
100000000000110101000000010001
110000011101010111100000000111
111101111101010111101000000001
111111111111111111111111111111
