111111111111
100000000001
101011110101
101010N00001
1010100011011
1000000000011
111111111111
