NO assets/base.png
SO assets/wall.png
WE assets/player.png
EA assets/exit.png

F 168,235,52
C 225,255,10

111111111111
100000000011
1001000000S1
101100000111
100000000011
111101111101
111111111111
